⣿⣿⣿⣟⣿⡛⠛⠛⣟⣻⠛⠻⡻⠿⡿⡿⡟⠛⠻⠛⡛⢛⣿⣟⢿⣿⣿
⣿⣿⣿⡉⠉⡻⢭⣵⣷⠆⠤⢀⡒⠄⠔⣸⡑⢆⣥⢥⠭⠝⠙⢏⣿⣿⣿
⣿⣿⣿⣷⣤⠈⠉⡁⠑⠓⡨⣻⡌⢹⣵⣄⠁⠂⠈⠀⠀⢀⢠⣾⣿⣿⣿
⣿⣿⣿⣿⢅⡃⠳⡶⣦⢄⡒⠶⠄⠈⠀⠀⢅⠀⣈⠐⠦⠘⣼⣿⣿⣿⣿
⣿⣿⣿⣿⣿⠎⣉⠍⠉⣗⣴⣋⣉⢘⣠⡶⠶⠶⠾⠓⠒⠰⣾⣿⣿⣿⣿
⣿⣿⣿⣿⣿⠀⣞⡾⠤⠤⣤⠤⠤⠀⠤⠄⠀⣜⣿⡛⠛⠁⣿⣿⣿⣿⣿
⣿⣿⣿⣿⣿⠘⣵⡆⢀⣾⣵⣤⠄⢰⡖⠒⠒⠿⠾⠿⠖⠄⣿⣿⣿⣿⣿
⣿⣿⣿⣿⣿⠀⠻⠃⢠⣤⣤⣤⣤⣾⡇⠰⣶⣒⣲⣶⣶⠄⣿⣿⣿⣿⣿
⣿⣿⣿⣿⣿⠀⡄⣠⣟⠄⠀⠀⣀⣀⣀⣰⣉⣉⣉⣉⡉⢡⣿⣿⣿⣿⣿
⣿⣿⣿⣿⣿⠀⠇⣹⣯⣀⣀⣸⣿⠉⠉⠉⠉⠙⠉⠙⣿⢸⣿⣿⣿⣿⣿
⣿⣿⣿⣿⣿⠀⠀⠉⠉⠉⠉⠉⠉⠀⠀⠀⢲⣶⣶⣶⣿⣾⣿⣿⣿⣿⣿
⣿⣿⣿⣿⣿⠀⣭⣤⣤⣤⣤⣤⣤⠀⠀⠀⢸⣷⠀⠀⠀⣿⣿⣿⣿⣿⣿
⣿⣿⣿⣿⣿⢀⣀⣀⣀⣀⣀⣸⣿⠀⠀⠀⣸⣿⡀⠀⠐⣿⣿⣿⣿⣿⣿
⣿⣿⣿⣿⢿⣞⡝⠛⠛⠛⠛⠛⠛⠀⠀⠀⡏⣿⡇⠀⣠⣻⢿⣿⣿⣿⣿
⣿⣿⣿⢒⢐⣲⢹⣲⣶⣶⣶⣶⣶⣤⣤⣤⣧⣿⣷⠀⡇⡆⢈⡤⣿⣿⣿
⣿⣿⣿⣿⣵⢮⠏⠀⠀⠀⠀⠛⠛⠛⠛⠛⠛⠛⠛⠀⠹⡿⣮⣷⣿⣿⣿
⣿⣿⣿⣿⣿⠀⣀⣀⣀⣀⣀⠀⠀⠀⠀⠀⠀⠀⠀⠀⠀⠄⣿⣿⣿⣿⣿
⣿⣿⣿⣿⣿⠈⠿⠿⢿⣿⣿⠀⠀⠀⠀⠀⠀⠀⣀⣀⣀⠇⣿⣿⣿⣿⣿
⣿⣿⣿⣿⣿⠀⠀⠀⢸⣿⡏⠀⠀⠀⠀⠀⣀⠀⣿⣿⡿⠢⣿⣿⣿⣿⣿
⣿⣿⣿⣿⣿⠀⠀⠀⣾⣿⣷⠀⠀⠀⠀⠀⠀⠀⢹⣿⣷⢁⣿⣿⣿⣿⣿
⣿⣿⣿⣿⣿⠀⠀⢀⣿⣿⢻⠀⠀⠀⠀⠀⠀⠀⠘⠛⠛⢀⣿⣿⣿⣿⣿
⣿⣿⣿⣿⣿⠀⠀⢸⣿⣿⣿⠀⠀⠀⠀⠀⠀⠀⠀⠀⠀⢰⣿⣿⣿⣿⣿
⣿⣿⣿⣿⣿⠀⠀⣿⣿⣿⣿⣿⣿⣿⣿⣿⣿⣿⣿⣿⣿⢈⣿⣿⣿⣿⣿
⣿⣿⣿⣿⣿⠀⠀⠛⠛⠛⠛⠛⠛⠛⠛⠛⠛⠛⠛⠛⠛⢈⣿⣿⣿⣿⣿
⣿⣿⣿⡟⠻⠰⢀⣀⡀⠀⠀⠀⠐⠲⣦⡀⠀⠀⠀⠀⡀⠆⠛⢿⣿⣿⣿
⣿⣿⣿⣧⢈⡨⣉⣿⣷⣁⣀⠀⠀⠀⣼⡗⣀⣀⣾⡟⣉⢁⣔⣾⣿⣿⣿
⣿⣿⣿⣿⢸⣇⣤⠉⢹⠟⠛⣋⣒⣿⣻⣛⠛⠻⠭⠑⣰⣿⡿⣿⣿⣿⣿
⣿⣿⣿⣿⣿⣶⣙⠸⢸⠸⠁⢿⣿⡇⢈⢸⢠⢚⡊⠠⣘⣶⣿⣿⣿⣿⣿
⣿⣿⣿⣿⣿⣿⣿⣿⣷⣶⣿⣯⣭⣭⣭⣽⣿⣶⣾⣿⣿⣿⣿⣿⣿⣿⣿
⣿⣿⣷⣿⣿⣿⣿⣿⣿⣿⣿⣿⣿⣿⣿⣿⣿⣿⣿⣿⣿⣿⣻⣿⣾⣿⣿
